2 1 4 1 1 4 1 1 4 1 1 4 1 1 4 1 1 4 1 1 4 1 1 4 1 1 4 1 1 4 1 3 
2 0 0 0 0 0 0 0 0 0 0 0 0 5 5 5 5 5 5 0 0 0 0 0 0 0 0 0 0 0 0 3 
2 0 0 0 0 0 0 0 0 0 0 0 5 5 0 0 0 0 5 5 0 0 0 0 0 0 0 0 0 0 0 3 
2 0 0 0 0 0 0 0 0 0 0 5 5 0 0 0 0 0 0 5 5 0 0 0 0 0 0 0 0 0 0 3
2 0 0 0 0 0 0 0 0 0 5 5 0 0 0 0 0 0 0 0 5 5 0 0 0 0 0 0 0 0 0 3 
2 0 0 0 0 0 0 0 0 5 5 0 0 0 0 0 0 0 0 0 0 5 5 0 0 0 0 0 0 0 0 3 
2 0 0 0 0 0 0 0 5 5 0 0 0 0 0 0 0 0 0 0 0 0 5 5 0 0 0 0 0 0 0 3 
2 0 0 0 0 0 0 5 5 0 0 0 0 0 0 0 0 0 0 0 0 0 0 5 5 0 0 0 0 0 0 3 
2 0 0 0 0 0 5 5 0 0 0 0 0 0 0 5 5 0 0 0 0 0 0 0 5 5 0 0 0 0 0 3 
2 0 0 0 0 5 5 0 0 0 0 0 0 0 0 5 5 0 0 0 0 0 0 0 0 5 5 0 0 0 0 3 
2 0 0 0 5 5 0 0 0 0 0 0 0 0 0 0 0 0 0 0 0 0 0 0 0 0 5 5 0 0 0 3 
2 0 0 5 5 0 0 0 0 0 0 0 0 0 0 0 0 0 0 0 0 0 0 0 0 0 0 5 5 0 0 3 
2 0 5 5 0 0 0 0 0 0 0 0 0 0 0 0 0 0 0 0 0 0 0 0 0 0 0 0 5 5 0 3 
2 5 5 0 0 0 0 0 0 0 0 0 0 0 0 0 0 0 0 0 0 0 0 0 0 0 0 0 0 5 5 3 
2 5 5 0 0 0 0 0 0 0 0 0 0 0 0 0 0 0 0 0 0 0 0 0 0 0 0 0 0 5 5 3 
2 0 5 5 5 5 5 5 5 5 5 5 5 5 5 5 5 5 5 5 5 5 5 5 5 5 5 5 5 5 0 3 
2 0 0 5 5 5 5 5 5 5 5 5 5 5 5 5 5 5 5 5 5 5 5 5 5 5 5 5 5 0 0 3 
2 1 4 1 1 4 1 1 4 1 1 4 1 1 4 1 1 4 1 1 4 1 1 4 1 1 4 1 1 4 1 3 